Butterfly	bươm bướm, sự kiêu sa
Cosy	ấm cúng 
Cute	xinh xắn đáng yêu
Renaissance	sự phục hưng
Sophisticated	sự tinh vi
Lullaby	bài hát ru con, sự dỗ dành
Bliss	niềm vui sướng vô bờ
Serendipity	sự tình cờ, may mắn
Twinkle	sự long lanh
Sunflower	hoa hướng dương
Blue	màu thiên thanh
Rainbow	cầu vồng, sự may mắn
Grace	sự duyên dáng
Hope	sự hy vọng
Enthusiasm	sự hăng hái, nhiệt tình
Cherish	yêu thương
Gorgeous	lộng lẫy, huy hoàng
Sweetheart	người yêu dấu
Transform	thay đổi, biến đổi
Sunshine	ánh nắng, sự hân hoan
Blossom	sự hứa hẹn, triển vọng
Peace	sự hoà bình
Tranquility	sự bình yên
Liberty	quyền tự do
Freedom	sự tự do
Destiny	số phận, định mệnh
Fantastic	xuất sắc, tuyệt vời
Eternity	sự bất diệt, vĩnh cửu
Love	tình yêu
Translate	Dịch
Cute	dễ thương
Cosmopolitan	vũ trụ
Sentiment	tình cảm
Kangaroo	chuột túi
Umbrella	ô, dù
Peek-a-boo	trốn tìm
Paradox	nghịch lý
Bumblebee	con ong
Banana	chuối
Pumpkin	bí ngô
Transit	sự đi qua, sự vượt qua
Bubble	bong bóng
Smile	nụ cười thân thiện
Passion	tình cảm, cảm xúc
Mother	người mẹ, tình mẫu tử
Transport	Vận chuyển
